##############
#           M#
# # ##########
# #          #
# ########## #
# ########## #
#            #
##### #####  #
#I       ## ##
##############